advantage - [ədˈvɑːntɪʤ] преимущество,выигрыш,плюс,перевес,выгодность
appliance - [əˈplaɪəns] прибор,применение,оборудование
according - [əˈkɔːdɪŋ] в зависимости от,в соответствии,по мнению,как
provide - [prəˈvaɪd] обеспечивать,предоставлять,предусматривать,давать,снабжать,заготовлять,представить,осуществлять,содержаться,служить
allow - [əˈlaʊ] позволять,допускать,предоставлять,учитывать,делать,признавать
spreadsheet - [ˈspredʃiːt] электронная таблица
handheld - [ˈhændheld] ручной,портативный
carried - [ˈkærɪd] перенесенный,проведенный,перевозимый,продолженный,доведенный
circuit - [ˈsɜːkɪt] цепь,схема,округ,кругооборот,автодром,обход,участок
enable - [ɪˈneɪbl] давать возможность,включить,дать,облегчать,приспосабливать
household - [ˈhaʊshəʊld] бытовой,семейный
referred - [rɪˈfɜːd] называемого
entertainment - [entəˈteɪnmənt] развлечение,прием,угощение,зрелище,зрелищность,забава,вечер,гостеприимство
unlike - [ˈʌnˈlaɪk] в отличие от,как
purpose - [ˈpɜːpəs] цель,назначение,намерение,целеустремленность,предмет,нужда,воля,успех
gradually - [ˈgrædjʊəlɪ] постепенно,последовательно
becoming - [bɪˈkʌmɪŋ] становление
influence - [ˈɪnflʊəns] влияние,фактор,влиятельность
variety - [vəˈraɪətɪ] сорт,разновидность,множество,многообразие,ряд,варьете,выбор,многосторонность
compatible - [kəmˈpætəbl] совместимый
throughout - [θruːˈaʊt] повсюду,на всем протяжении,во всех отношениях,в продолжение,совершенно
various - [ˈvɛərɪəs] различный,разносторонний
receiving - [rɪˈsiːvɪŋ] получение,принятие
interlink - [ɪntəˈlɪŋk] связующее звено
superhighway - [suːpəˈhaɪweɪ] автострада,супермагистраль,супершоссе
boardroom - [ˈbɔːdruːm] зал заседаний
coat - [kəʊt] пальто,слой,мундир,оболочка,шкура,покров,мех,покрытие,герб,шуба,шерстный покров,грунт,френч,верхнее платье,оперение


instant - [ˈɪnstənt] мгновенный,растворимый,настоящий,настоятельный,прямой,быстрый
general-purpose - [ˈʤenərəl-ˈpɜːpəs] универсальный
goal - [gəʊl] цель,гол,ворота
to this end - с этой целью
balances simplicity - остатки простоты
expressiveness - [ɪkˈspresɪvnəs] выразительность,выраженность,экспрессия
performance - [pəˈfɔːməns] производительность,исполнение,выступление,представление,работа,игра,действие,эксплуатационные качества,спектакль,характеристика,перформанс,постановка,свершение,поступок
is general - общие
statement - [ˈsteɪtmənt] инструкция
sequentially - [sɪˈkwenʃəlɪ] последовательно
higher-level - [ˈhaɪə-levl] более высокий уровень
another - [əˈnʌðə] другой
member - [ˈmembə] член,участник,партнер,элемент