advantage - [ədˈvɑːntɪʤ] преимущество,выигрыш,плюс,перевес,выгодность
appliance - [əˈplaɪəns] прибор,применение,оборудование
benefit - [ˈbenɪfɪt] выгода,преимущество,пособие,благо,прибыль,привилегия,пенсия,Бенефис,эффект,выигрыш
attachment - [əˈtæʧmənt] привязанность,прикрепление,насадка,присоединение,приставка,вложение,приложение,пристрастие,принадлежность,прикрепленный файл,привязка,оснастка,наложение ареста
appropriate - [əˈprəʊprɪɪt] соответствующий,подходящий,уместный,свойственный
boardroom - [ˈbɔːdruːm] зал заседаний
call monitoring - контроль звонков
clipart - [klaɪˈpɑːt] графический элемент
connectivity - [kənekˈtɪvɪtɪ] связность,подключение,связь,подключаемость
device - [dɪˈvaɪs] устройство,прибор,аппарат,механизм,план,прием,средство,установка,способ,девиз,эмблема,затея
disabled - [dɪsˈeɪbld] искалеченный,блокированный,отключенный,запрещенный,деактивированный
efficiency - [ɪˈfɪʃnsɪ] эффективность,рентабельность,отдача,деловитость,кпд,дееспособность,умение,подготовленность
endure - [ɪnˈdjʊə] терпеть,выдержать,вынести,продолжаться,претерпеть,сносить,испытывать
engine - [ˈenʤɪn] двигатель,механизм,машина,локомотив,орудие
environment - [ɪnˈvaɪərənmənt] окружающая среда,оборудование,экология,климат,пространство,природа,конъюнктура,окружающий
equipment - [ɪˈkwɪpmənt] оборудование,снаряжение,оснастка,техника,устройство,инвентарь,комплектация,оборудованье,подвижной состав
forwarding - [ˈfɔːwədɪŋ] пересылка,экспедитор
superhighway - [suːpəˈhaɪweɪ] автострада,супермагистраль,супершоссе
inventory - [ˈɪnvəntrɪ] инвентаризация,запас,инвентарь,реестр,инвентарная ведомость,кадастр,предметы
landscape - [ˈlænskeɪp] пейзаж,озеленение
opportunity - [ɔpəˈtjuːnɪtɪ] перспектива,возможность,удобный случай
password - [ˈpɑːswɜːd] пароль,пропуск
relevance - [ˈrelɪvəns] значимость,релевантность,уместность,существенность,отношение,соответствие,востребованность,адекватность,обоснованность
remote - [rɪˈməʊt] удаленный,отдаленный,труднодоступный,глухой,небольшой,слабый
research - [rɪˈsɜːʧ] исследование,поиск,нир
significantly - [sɪgˈnɪfɪkəntlɪ] значительно,многозначительно,сильно,примечательно
sophisticated - [səˈfɪstɪkeɪtɪd] сложный,изощренный
spreadsheet - [ˈspredʃiːt] электронная таблица
supervision - [sjuːpəˈvɪʒən] надзор,присмотр,сопровождение,шефмонтаж,кураторство
to determine - [dɪˈtɜːmɪn] определять,устанавливать,обусловливать,предопределять,побуждать
to encourage - [ɪnˈkʌrɪʤ] поощрять,ободрять,поддерживать,подстрекать,потворствовать,призывать,вдохновлять
to perform - [pəˈfɔːm] выполнять,совершать,играть,делать,проводить,производить,работать
to enhance - [ɪnˈhɑːns] повышать,усиливать,расширить
to proliferate - [prəʊˈlɪfəreɪt] пролиферировать,распространяться,быстро увеличиваться
to require - [rɪˈkwaɪə] требовать,приказывать,предполагать,запрашивать
to telecommute - [] дистанцироваться
to upload - [ʌpˈləʊd] загружать,выгрузить,отправить,выложить
vacuum/sealed  case - вакуумно-герметичный корпус
videoconferencing - [vɪdɪəʊˈkɒnfərənsɪŋ] видеоконференция
weak - [wiːk] слабый,немощный,неэффективный,непрочный,бедный,неубедительный,безвольный,уязвимый,слабоватый